NO ./assets/respawn_anchor_bottom.xpm
SO ./assets/smooth_stone_slab_side.xpm
WE ./assets/smooth_stone.xpm
EA ./assets/bookshelf.xpm

F 0,0,0
C 0,0,0

111111111
100000001
100000001
100000001
100010001
100000001
100000001
1000N0001
111111111