NO ../assets/arrow_n.xpm
PO ../assets/arrow_s.xpm
EA ../assets/arrow_e.xpm
WE ../assets/arrow_w.xpm

F 187,159,6
C 61,61,61

1111111111111111111111111111
1000000100000100000000000001
1011110101110101110111110101
1010000100010100000100010101
1010110101110101110101010101
1000100100000100000100000101
1011101101010110110110100101
1110000000000100000100000101
1000111111111111110110100101
1111111111111111111111111111