NO 8=D
SO 8=D
WE 8=D
EA 8=D

F 50,100,100
C 0,0,255

111111111111
100000000001
111110011111
11111N011111
100000000001
100R00000001
1000000000011111111
100001100011
111111111111