NO ./assets/deepslate_tiles.xpm
SO ./assets/deepslate_tiles.xpm
EA ./assets/deepslate_tiles.xpm
WE ./assets/deepslate_tiles.xpm

F 42,42,42
C 61,61,61

1111111111111111111111111111
1000000100000100000000000001
1011110101110001110111110101
1010000100010100000100010101
1010110101110101110101010101
1000100100000100000100000101
1011101101010110110110100101
1110000000000100000100000101
100W111111111111110110100101
1111111111111111111111111111