111111111111    111111111111
1000N0000001    100000000001
11111N011111    100000000001
111110011111    100000000001
100001000001    100000000001
100011110001    111111111111
1000010000011111111
10001100111
111111111111