NO 
SO ../assets/arrow_s.xpm
EA ../assets/arrow_e.xpm
WE ../assets/arrow_w.xpm

F 187,159,6
C 61,61,61

111111111111    1111111111111
100000000001    1000000000001
111110011111    1000000000001
111110011111    10000000N0001
100001000001    1000000000001
100011110001    1111111111111                     
111111111111111111     1
1000010000011111111
100011001111111111
111111111111